# # # 0 #
F 0 # S 0
# 0 # 0 #
0 0 0 0 #
# 0 # 0 #
5
